11111111111111111
1P100000000000101
10010000000001001
10001000000010001
10000100000100001
10000010001000001
10000000110000001
10000000110000001
10000001001000001
10000010000100001
10000100000010001
10001000000001001
10010000000000101
1E1000000000000C1
11111111111111111