1111111111111111111111111111111111
1P00000000000000000000000000000001
1000000000000000000000000000000001
1000001111100000111100011110000001
1000001000000000100000010000000001
1000001111100000111100010000000001
1000001000000000000100010000000001
1000001000000000000100010000000001
1000001111110000111100011110000001
1000000000000000000000000000000001
1000000000000000000000000000000001
1000000000000000000000000000000001
1E000000000000000000000000000000C1
1111111111111111111111111111111111