11111111111111111111
1PA011E0000C10000001
11111111111111111111