11111111111111111111
10010000000C110011C1
10000111110000100001
1P0011E0000C10000001
10001100000000000101
10001100000000000101
10001100011101100101
10001101000A0C000101
10001100011000100101
10001100000010C00101
10001100010000000101
11111111111111111111