111111111111111111111
1011110011100000110E1
10P10000001001C1C0011
1001C0000000110100001
110001000000101001101
100000111000011010001
1000000C0011001000101
110010111100C10000011
100000000001100A001C1
101011111000011111011
111111111111111111111