1111111111
1000000001
1PCCCE0001
1111111111