11111111111111111111
10000000000011001001
10000000000000100001
100000E0000C10000001
10000000P00000000101
100C000000C000000101
10000000000001100101
10000001000000000101
10000000000000100101
10001100000010000101
100011000100000001A1
11111111111111111111